WWWWWWWWWWWWWWWWWWWW
WGWWSW             W
WWWWWW WWWWW WWWWW W
WGWWWW GG          W
WWWWWW WWWWW WWWWW W
WWWWWW             W
WWWWWWWWWWWWWWWWWWWW
