WWWWWWWWWWWWWWWWWWWWWWWWW
WS                      W
W WW WWWWWWWWWWWWWWWWWW W
W    WWWWWWWWWWWWWWWWWW W
W WW WWWWWWWWWWWWWWWWWW W
W          G G G G      W
WWWWWWWWWWWWWWWWWWWWWWWWW
