WWWWWWWWWWWWWWWWWWWWWWWWWWWWWWWWWWWWWWWWWWWWWWWWWW
W     G                    G        G            W
W WWWWWWWWWW WWWW WWWWW WWWWWW WWWWWWWWWWWWWWWWW W
W WWWWWWWWWW WWWW WWWWW WWWWWW WWWWWWWW          W
W WWWWWWWWWW WWWW WWWWW WWWWWW WWWWWWWW WWWWWWWW W
W        WWW  G   WWWWW WWWWWW WWWWWWWW WWWWWWWW W
W WWWWWW WWWWWWWW WWWWW           G              W
W WWWWWW WWWWWWWW WWWWW WWW WWWWWWWWWWWWWW WWWWW W
W WWWWWW WWWWWWWW WWWWW WWW WWWWWWWWWWWWWW WWWWW W
W WWWWWW WWWWWWWW WWWWW WWW WWWWWWW        WWWWW W
W WWWWWW    G     WWWWW WWW WWWWWWWWWWWWWW WWWWW W
W WWWWWWWWWWWWWWW WWWWW WWW WWWWWWWWWWWWWW WWWWW W
W WWWWWWWWWWWWWWW WWWWW WWW    G    WWWWWW WWWWW W
W WWWWWWWWWWWWWWW WWWWW WWWWWWWWWWW WWWWWW WWWWW W
W         S             WWWWWWWWWWW WWWWWW WWWWW W
W WWWWW WWWWW WWWWWWWWW WWWWWWWWWWW WWWWWW WWWWW W
W WWWWW WWWWW WWWWWWWWW WWWWWWWWWWW        WWWWW W
W WWWWW WWWWW WWWWWWWWW WWWWWWWWWWWWWWWWWW WWWWW W
W                                                W
WWWWWWWWWWWWWWWWWWWWWWWWWWWWWWWWWWWWWWWWWWWWWWWWWW
