WWWWWWWWWWWWWWW
WWWWWWWWWWW WWW
WWWWWWWWWWW WWW
WS            W
WWWWWWWWWWW WWW
WWWWWWWWWWW WWW
WWWWWWWWWWWWWWW
